NO ./path_to_the_north_texture
SO ./path_to_the_south_texture
WE ./path_to_the_west_texture
EA ./path_to_the_east_texture
F 220,100,0
C 225,30,0
1111111111111111111111111
10000001100000000000111
111100000111000000000001111
   10010000000000000000000011111111111
111111111011000001110000000000000001
10000000001100000111011111111111111
1111011111111101110000001000111
11110111101 1101010010001  1
1100000011010101110000001000111
10000000000000001100000010001
10000000000000001101010010001
1100000110101011111011110N0001
11110111 1110101 1011110100001
11111111 1111111 111111111111
