
NO	1

	C 255,255,222

			F 1,1,1
SO	2

EA 1


WE 1

111111
10000E11
 11111
