
	NO ./textures/North.xpm

		SO ./textures/South.xpm
 WE ./textures/West.xpm
EA ./textures/East.xpm


C 161,198,234

F 7, 136, 60

 11111111111111111111111111
1000000110000000000011101
111100000111000000000001111
   10010000000000000000000011111111
111111111011000001110000000000000001
10000000001100000111011111111111111
1111011111111101110000001000111
11110111101 1101010010001    1
1100000011010101110000001000111
10000000000000001100000010001
10000000000000001101010000001
1100000110101011111011000N0001
 1110111 1110101 1011110100001
1 111111 1111111 111111111111


