
NO	1.xpm
NO	1.xpm

	C 255,255,222

			F 1,1,1
SO	2.xpm

EA 1.xpm



WE 1.xpm

111111111
10000E0101
 11111111
